5,1,3,4,2
4,2,5,3,1
2,3,4,1,5
1,4,2,5,3
3,5,1,2,4