4,5,1,2,3
3,2,5,4,1
2,1,4,3,5
5,3,2,1,4
1,4,3,5,2