1,5,3,4,2
4,2,1,5,3
5,3,4,2,1
2,1,5,3,4
3,4,2,1,5