0,0,7,1,5,0,9,0,0
0,0,9,4,3,0,0,0,0
5,0,0,0,0,2,0,1,3
0,0,6,5,0,4,0,2,9
4,3,0,0,8,0,0,5,7
9,7,0,3,0,1,4,0,0
7,6,0,2,0,0,0,0,5
0,0,0,0,9,6,2,0,0
0,0,3,0,4,5,6,0,0