3,2,7,1,5,8,9,4,6
6,1,9,4,3,7,5,8,2
5,4,8,9,6,2,7,1,3
1,8,6,5,7,4,3,2,9
4,3,2,6,8,9,1,5,7
9,7,5,3,2,1,4,6,8
7,6,4,2,1,3,8,9,5
8,5,1,7,9,6,2,3,4
2,9,3,8,4,5,6,7,1