3,2,1,6,5,8,9,4,7
7,8,4,3,1,9,2,6,5
9,5,6,7,2,4,1,3,8
5,4,9,1,3,2,7,8,6
6,7,2,4,8,5,3,1,9
8,1,3,9,7,6,5,2,4
1,9,5,8,6,3,4,7,2
4,3,8,2,9,7,6,5,1
2,6,7,5,4,1,8,9,3