1,0,0,0,0,0,0,0,9
0,4,0,2,6,1,0,3,0
0,6,0,0,5,0,0,1,0
0,0,5,6,0,3,4,0,0
8,1,4,7,0,5,3,9,6
0,0,9,0,1,0,7,0,0
0,0,0,9,3,4,0,0,0
4,8,0,5,7,2,0,6,3
3,0,0,0,0,0,0,0,5