3,2,1,0,5,0,9,4,7
7,8,0,0,1,0,0,6,5
0,0,6,7,0,4,1,0,0
5,4,9,0,0,0,7,8,6
0,0,0,0,0,0,0,0,0
0,0,0,9,0,6,0,0,0
1,0,5,0,6,0,4,0,2
0,3,0,2,0,7,0,5,0
2,0,7,0,4,0,8,0,3