3,4,1,2,5
5,2,4,3,1
2,1,3,5,4
1,5,2,4,3
4,3,5,1,2