1,5,3,8,4,7,6,2,9
9,4,8,2,6,1,5,3,7
7,6,2,3,5,9,8,1,4
2,7,5,6,9,3,4,8,1
8,1,4,7,2,5,3,9,6
6,3,9,4,1,8,7,5,2
5,2,6,9,3,4,1,7,8
4,8,1,5,7,2,9,6,3
3,9,7,1,8,6,2,4,5